ARE	AA R
ARE(2)	ER
BROWSER	B R AW Z ER
CLOSE	K L OW S
CLOSE(2)	K L OW Z
COLOR	K AH L ER
COLOR(2)	K AO L ER
CREATOR	K R IY EY T ER
FAVOURITE	F EY V ER IH T
HOW	HH AW
IS	IH Z
MEDIA	M IY D IY AH
NAME	N EY M
OPEN	OW P AH N
PLAYER	P L EY ER
SLEEP	S L IY P
UP	AH P
WAKE	W EY K
WHAT	W AH T
WHAT(2)	HH W AH T
WHO	HH UW
YOU	Y UW
YOUR	Y AO R
YOUR(2)	Y UH R